############################
#                          #
#                          #
#                          #
#                          #
#                          #
#                          #
#                          #
#                          #
#                          #
#                          #
#                          #
############################